border_size=1
usage=map

Mm^Xm       , Mm          , Mm^Xm       , Mm^Xm       , Mm^Xm       , Mm^Xm       , Mm^Xm       , Hh          , Ww          , Hh          , Hh          , Mm          , Mm          , Mm          , Mm          , Mm          , Mm          , Mm          , Mm          , Mm          , Mm          , Mm          , Hh          , Hh          , Ds          , Hh          , Hh          , Hh          , Mm          , Hh          , Hh          , Rd          , Hh          , Mm          , Mm          , Mm          , Mm          , Mm          , Hh          , Mm          , Mm          , Mm          
Mm^Xm       , Mm^Xm       , Mm^Xm       , Mm^Xm       , Mm^Xm       , Mm^Xm       , Mm^Xm       , Hh          , Hh          , Ww          , Hh          , Mm          , Mm          , Mm          , Mm          , Mm          , Mm          , Mm          , Mm          , Mm          , Mm          , Mm          , Hh          , Ds          , Ql          , Ds          , Ds          , Hh          , Mm          , Hh          , Rd          , Rd          , Hh          , Mm          , Mm          , Mm          , Hh          , Hh          , Hh          , Mm          , Mm          , Mm          
Mm^Xm       , Mm^Xm       , Mm^Xm       , Mm^Xm       , Mm          , Mm^Xm       , Mm^Xm       , Mm^Xm       , Gs^Fp       , Ww          , Gs^Fp       , Hh          , Mm          , Mm          , Mm          , Hh          , Mm          , Mm          , Mm          , Mm          , Hh          , Hh          , Rd          , Ds          , Ds          , Ql          , Ds          , Hh          , Mm          , Hh          , Rd          , Hh          , Hh          , Mm          , Mm          , Hh          , Mm          , Mm          , Mm          , Hh          , Mm          , Mm          
Mm^Xm       , Mm^Xm       , Mm          , Mm          , Ch          , Mm          , Mm          , Hh          , Gs^Fp       , Ww          , Gs^Fp       , Hh          , Mm^Vhh      , Mm          , Mm          , Mm          , Mm          , Mm          , Hh          , Hh          , Rd          , Rd          , Hh          , Hh          , Ds          , Ql          , Ds          , Hh          , Hh          , Hh          , Rd          , Hh          , Hh^Vhh      , Mm          , Hh          , Hh          , Mm          , Mm          , Mm          , Mm          , Mm          , Mm          
Mm          , Mm          , Mm          , Ch          , 2 Kh        , Ch          , Mm          , Hh          , Gs^Fp       , Ww          , Gs          , Hh          , Hh          , Hh          , Hh          , Hh          , Hh          , Hh          , Rd          , Rd          , Mm          , Mm          , Mm          , Hh          , Hh          , Ds          , Hh          , Rd          , Rd          , Hh          , Rd          , Hh          , Hh          , Hh          , Mm          , Mm          , Mm          , Mm          , Mm          , Mm          , Mm          , Mm          
Mm          , Mm          , Mm          , Ch          , Ch          , Ch          , Mm          , Hh          , Gs          , Ww          , Ww          , Gs^Fp       , Gs^Fp       , Hh          , Rd          , Gs^Fp       , Rd          , Rd          , Hh          , Hh          , Mm          , Mm          , Mm          , Mm          , Mm          , Mm          , Mm          , Hh          , Hh          , Rd          , Hh          , Rd          , Rd          , Hh          , Hh          , Mm          , Mm          , Mm          , Mm          , Mm          , Mm          , Mm          
Mm          , Mm          , Mm          , Mm          , Rd          , Mm          , Mm          , Hh          , Hh          , Gs^Fp       , Ww          , Gs^Fp       , Rd          , Rd          , Hh          , Rd          , Hh          , Hh          , Mm          , Mm          , Mm          , Mm          , Mm          , Mm^Vhh      , Ww          , Ww          , Ww          , Mm          , Mm          , Hh          , Mm          , Hh          , Rd          , Hh          , Hh          , Mm          , Mm          , Mm          , Mm          , Mm          , Mm          , Mm          
Mm          , Mm          , Mm          , Hh          , Rd          , Hh          , Mm          , Mm          , Hh          , Gs^Fp       , Wwf         , Rd          , Gs^Fp       , Hh          , Hh          , Hh          , Mm          , Mm          , Mm          , Mm          , Mm          , Mm          , Mm          , Mm          , Mm          , Ww          , Mm          , Mm          , Mm          , Mm          , Mm          , Hh          , Hh          , Rd          , Rd          , Mm          , Hh          , Mm          , Mm^Vhh      , Mm          , Mm          , Mm          
Mm          , Mm          , Mm          , Hh^Vhh      , Rd          , Hh          , Hh          , Hh          , Rd          , Rd          , Gs^Fp       , Ww          , Gs^Fp       , Mm          , Mm          , Mm          , Mm          , Mm          , Mm          , Mm          , Mm          , Mm          , Mm          , Mm          , Mm          , Ww          , Mm          , Mm          , Mm          , Mm          , Mm          , Mm          , Mm          , Mm          , Hh          , Rd          , Hh          , Mm          , Mm          , Mm          , Mm          , Mm          
Mm          , Mm          , Hh          , Hh          , Rd          , Hh          , Rd          , Rd          , Hh          , Hh          , Gs^Fp       , Ww          , Gs^Fp       , Mm          , Mm          , Mm          , Mm^Vhh      , Mm          , Mm          , Hh          , Hh          , Mm          , Mm          , Mm          , Mm          , Wwf         , Mm          , Mm          , Mm          , Mm          , Mm^Vhh      , Mm          , Mm          , Hh          , Hh          , Rd          , Rd          , Hh          , Hh          , Mm          , Mm          , Mm          
Mm          , Hh          , Mm          , Hh          , Hh          , Rd          , Gs          , Hh          , Hh          , Hh          , Gs^Fp       , Ww          , Ww          , Gs^Fp       , Mm          , Mm          , Mm          , Mm          , Mm          , Hh          , Hh          , Mm          , Mm          , Mm          , Mm          , Ww          , Ww          , Mm          , Mm          , Mm          , Mm          , Mm          , Mm          , Mm          , Mm          , Hh          , Hh          , Rd          , Hh          , Mm          , Mm          , Mm          
Mm          , Mm          , Mm          , Mm          , Hh          , Rd          , Hh          , Hh          , Hh          , Mm          , Hh          , Gs^Fp       , Ww          , Gs^Fp       , Gs^Fp       , Mm          , Mm          , Mm          , Mm          , Mm          , Hh          , Mm          , Mm          , Mm          , Mm          , Hh          , Ww          , Hh          , Mm          , Mm          , Mm          , Mm          , Mm          , Mm          , Mm          , Mm          , Hh          , Rd          , Ch          , Mm          , Mm          , Mm          
Mm          , Mm          , Mm          , Mm          , Hh          , Rd          , Gs          , Hh          , Mm          , Mm^Vhh      , Hh          , Gs^Fp       , Gs          , Ww          , Gs^Fp       , Mm          , Mm          , Mm          , Hh          , Hh          , Mm          , Mm          , Mm          , Mm          , Mm          , Hh          , Ww          , Gs^Fp       , Mm          , Mm          , Mm          , Mm          , Mm          , Mm          , Mm          , Mm          , Hh          , Ch          , 1 Kh        , Ch          , Mm          , Mm          
Mm          , Mm          , Hh          , Mm          , Hh          , Rd          , Gs          , Hh          , Hh          , Hh          , Hh          , Hh          , Gs^Fp       , Ww          , Gs^Fp       , Mm          , Hh          , Hh          , Hh          , Hh          , Hh          , Hh          , Hh          , Hh          , Hh          , Hh          , Ww          , Gs^Fp       , Hh          , Mm          , Mm          , Mm          , Mm          , Mm          , Mm          , Hh          , Hh          , Ch          , Ch          , Ch          , Mm          , Mm          
Hh          , Hh          , Hh          , Hh          , Rd          , Rd          , Rd          , Hh          , Hh          , Gs          , Hh          , Hh          , Gs^Fp       , Ww          , Ww          , Hh          , Rd          , Rd          , Rd          , Rd          , Rd          , Rd          , Rd          , Rd          , Rd          , Hh          , Wwf         , Hh          , Hh          , Hh          , Hh          , Mm          , Hh          , Mm          , Hh          , Hh          , Hh^Vhh      , Hh          , Rd          , Hh          , Hh          , Mm          
Rd          , Rd          , Rd          , Rd          , Hh          , Gg^Fet      , Hh          , Rd          , Rd          , Hh          , Hh          , Hh          , Hh          , Gs^Fp       , Ww          , Gs^Vht      , Wwf         , Gs          , Gs          , Gg^Fet      , Gs          , Gs          , Gs^Fp       , Gs^Fp       , Gg^Fet      , Rd          , Ww          , Rd          , Rd          , Rd          , Rd          , Hh          , Rd          , Hh          , Rd          , Hh          , Rd          , Hh          , Rd          , Hh          , Rd          , Hh          
Hh          , Hh          , Hh          , Hh          , Hh          , Hh          , Hh          , Hh          , Rd          , Gs          , Hh          , Gs          , Hh          , Hh          , Hh          , Wwf         , Gs          , Ww          , Ww          , Gs          , Ww          , Gs^Fp       , Ww          , Ww          , Ww          , Gs          , Ww          , Gs          , Gs          , Gs^Vht      , Gs^Fp       , Rd          , Gs^Fp       , Rd          , Gs^Fp       , Rd          , Gs          , Rd          , Gs          , Rd          , Gs          , Hh          
Mm          , Mm          , Mm          , Hh          , Hh          , Hh^Vhh      , Hh          , Mm          , Mm          , Rd          , Rd          , Rd          , Rd          , Hh          , Rd          , Rd          , Gs          , Ww          , Ww          , Ww          , Ww          , Ww          , Ww          , Ww          , Ww          , Ww          , Gs^Fp       , Ww          , Wwf         , Gs^Fp       , Ww          , Gs^Fp       , Ww          , Gs^Fp       , Ww          , Gs^Fp       , Ww          , Gs          , Wwf         , Gs          , Ww          , Gs          
Mm          , Mm          , Mm          , Mm          , Hh          , Hh          , Hh          , Mm          , Mm          , Mm          , Mm          , Hh          , Hh          , Rd          , Hh          , Hh          , Gs          , Gs          , Gg^Fet      , Ww          , Ww          , Ww          , Gg^Fet      , Ww          , Gs          , Gs          , Gs          , Gs          , Gs          , Ww          , Gs^Fp       , Ww          , Gs          , Ww          , Gs^Fp       , Ww          , Gs          , Ww          , Gs          , Ww          , Gs          , Ww          
Mm          , Mm          , Mm          , Mm          , Hh          , Hh          , Mm          , Mm          , Mm          , Mm          , Mm          , Mm          , Mm          , Hh          , Mm          , Hh          , Hh          , Gs          , Gs          , Gs^Vht      , Wwf         , Gs^Fp       , Gs          , Gs          , Hh          , Hh          , Hh          , Hh          , Hh          , Gs^Fp       , Gs          , Gs^Fp       , Gs^Fp       , Gs^Fp       , Gs^Fp       , Gs^Fp       , Hh          , Gs          , Gs^Vht      , Gs          , Hh          , Gs          
Mm          , Mm          , Mm          , Mm          , Hh          , Hh          , Hh          , Mm          , Mm          , Hh          , Mm          , Mm          , Mm          , Mm          , Mm          , Hh          , Mm          , Hh          , Hh          , Gs          , Ww          , Gs          , Hh          , Gs          , Hh          , Hh          , Mm          , Hh          , Mm          , Hh          , Hh          , Hh          , Hh          , Hh          , Hh          , Hh          , Mm          , Hh          , Hh          , Hh          , Hh          , Hh          
Mm          , Mm          , Mm          , Mm          , Hh          , Hh          , Hh          , Mm          , Mm          , Mm          , Mm          , Mm^Vhh      , Mm          , Mm          , Mm          , Mm          , Mm          , Mm          , Hh          , Gs          , Ww          , Gs^Fp       , Hh          , Hh          , Mm          , Mm          , Mm          , Mm          , Mm          , Mm          , Hh          , Hh          , Mm          , Hh          , Mm          , Mm          , Mm          , Mm          , Mm          , Mm          , Mm          , Mm          
Mm          , Mm          , Mm          , Mm          , Mm          , Hh          , Hh          , Mm          , Mm          , Mm          , Mm          , Mm          , Mm          , Mm          , Mm          , Mm          , Mm          , Mm          , Mm          , Gs^Fp       , Ww          , Gs^Fp       , Gs^Fp       , Mm          , Mm^Vhh      , Mm          , Mm          , Mm          , Mm          , Mm          , Hh          , Hh          , Mm          , Mm          , Mm          , Mm          , Mm          , Mm          , Mm          , Mm          , Mm          , Mm          
Mm          , Mm          , Mm^Vhh      , Mm          , Mm          , Hh          , Hh          , Hh          , Hh          , Mm          , Mm          , Mm          , Mm          , Hh          , Mm          , Mm          , Mm          , Mm          , Mm          , Gs^Fp       , Hh          , Ww          , Hh          , Mm          , Mm          , Mm          , Hh          , Hh          , Mm          , Mm          , Hh          , Hh          , Mm          , Mm          , Hh          , Hh          , Hh          , Hh          , Mm          , Mm          , Mm          , Mm          
Mm          , Mm          , Mm          , Mm          , Mm          , Hh          , Hh          , Hh          , Hh          , Mm          , Mm          , Mm          , Mm          , Hh          , Mm          , Mm          , Mm          , Mm          , Mm          , Mm          , Gs^Fp       , Ww          , Gs^Fp       , Mm          , Mm          , Mm          , Mm          , Mm          , Mm          , Mm          , Hh          , Hh^Vhh      , Hh          , Hh          , Mm          , Mm          , Mm          , Mm          , Mm          , Mm          , Mm          , Mm          
Mm          , Mm          , Mm          , Mm          , Mm          , Hh          , Mm          , Hh          , Mm          , Mm          , Mm          , Mm          , Mm          , Hh          , Hh          , Mm          , Mm          , Mm          , Mm          , Mm          , Gs^Fp       , Ww          , Hh          , Mm          , Mm          , Mm          , Mm          , Mm          , Mm          , Mm          , Mm          , Hh          , Hh          , Mm          , Mm          , Mm          , Mm          , Mm          , Mm          , Mm          , Mm          , Mm          
Mm          , Mm          , Mm          , Mm          , Mm          , Mm          , Mm          , Mm          , Mm          , Mm          , Mm          , Mm          , Mm          , Hh          , Hh          , Mm          , Mm          , Mm          , Mm          , Mm          , Gs^Fp       , Ww          , Hh          , Mm          , Mm          , Mm          , Mm          , Mm          , Mm          , Mm          , Mm          , Hh          , Hh          , Mm          , Mm          , Mm          , Mm          , Mm          , Mm          , Mm          , Mm          , Mm          
