border_size=1
usage=map

Hh          , Hh          , Hh          , Hh          , Hh          , Hh          , Gg          , Gg          , Gs^Fp       , Gg          , Gg          , Gg          , Ww          , Gg          , Gg          , Gg          , Gg          , Gg          , Gg          , Hh          , Hh          , Hh          
Hh          , Hh          , Hh          , Hh          , Gg          , Gg          , Gg          , Gg          , 5 Gs^Fp     , Gg          , Gg          , Gg          , Ww          , Gg          , Gs^Fp       , Gg          , Gg          , Gg          , Gg          , Hh          , Hh          , Hh          
Hh          , Hh          , Hh          , Gg          , Gg          , Ggf         , Gg          , Gg          , Gg          , Gs^Fp       , Gg          , Gg          , Ww          , Gg          , Gg          , 4 Gs^Fp     , Gg          , Gg          , Gg          , Hh          , Hh          , Hh          
Hh          , Hh          , Hh          , Hh          , Gg          , Gg          , Gg          , Gg          , Gg          , Gg          , Gg          , Gg          , Ww          , Gg          , Gg          , Gg          , Gg          , Gg          , Hh          , Hh          , Hh          , Hh          
Hh          , Hh          , Hh          , Hh          , Gg          , Gg          , Gg          , 3 Gg        , Gg          , Gg          , Wwf         , Ww          , Gg          , Gg          , Gg          , Ggf         , Gg          , Gg          , Hh          , Hh          , Hh          , Hh          
Hh          , Hh          , Hh          , Hh          , Hh          , Gg          , Gg          , Gg          , Gg          , Gg          , Ww          , Gg          , Gg          , Gg          , Gg          , Gg          , Gg          , Gg          , Gg          , Gg          , Hh          , Hh          
Hh          , Hh          , Mm          , Hh          , Hh          , Gg          , Gg          , Ggf         , Gg          , Gg          , Ww          , Gg          , Gg          , Gg          , Gs^Fp       , Gg          , Gg          , Gg          , Hh          , Hh          , Hh          , Hh          
Hh          , Hh          , Hh          , Hh          , Hh          , Gg          , Gg          , Gg          , Gg          , Gg          , Ww          , Gg          , Gg          , Gg          , Gg          , Gs^Fp       , Gg          , Gg          , Hh          , Hh          , Hh          , Hh          
Hh          , Hh          , Hh          , Gg^Vh       , Gg          , Ggf         , Gg          , Gg          , Gs^Fp       , Gg          , Gg          , Ww          , Gg          , Gs^Fp       , Gs^Fp       , Gg          , Gg          , Gg          , Hh          , Mm          , Hh          , Hh          
Hh          , Hh          , Hh          , Hh          , Hh          , Gg          , Gg          , Gs^Fp       , Gs^Fp       , Gg          , Gg          , Ww          , Gg          , Gg          , Gs^Fp       , Gg          , Gg          , Ggf         , Gg          , Hh          , Hh          , Hh          
Hh          , Hh          , Hh          , Hh          , Hh          , Gg          , Gg          , Gs^Fp       , Gg          , Gg          , Gg          , Wwf         , Ww          , Gg          , Gg          , Gg          , Gg          , Gg          , Gg          , Hh          , Hh          , Hh          
Hh          , Hh          , Hh          , Mm          , Hh          , Gg          , Gg          , Gg          , Gg          , Gg          , Gg          , Ww          , Ww          , Gg          , Gg          , Gg          , Gg          , Gg          , Gg          , Hh          , Mm          , Hh          
Hh          , Gg          , Gg          , Hh          , Hh          , Hh          , Gs^Fp       , Gg          , Gs^Fp       , Gg          , Gg          , Gg          , Ss          , Ww          , Gg^Vh       , Gg^Fet      , Ggf         , Gg          , Gg          , Hh          , Hh          , Hh          
Hh          , Hh          , Hh          , Gg          , Gg          , Gs^Fp       , Gg          , Gs^Fp       , Gs^Fp       , Gg          , Gg          , Gg          , Ss          , Ww          , Gg          , Gg          , Gg          , Gg          , Gg          , Gg          , Gg          , Hh          
Hh          , Hh          , Hh          , Hh          , Hh          , Gg          , Ggf         , Gg          , Ggf         , Gg          , Gg^Fet      , Gg          , Ss          , Ww          , Gg          , Gg          , Gg          , Gg          , Gg          , Hh          , Hh          , Hh          
Hh          , Hh          , Hh          , Mm          , Hh          , Gg          , Gg          , Gg          , Gg          , Gg          , Gg          , Gg          , Ww          , Ww          , Gg          , Ggf         , 2 Gg        , Hh          , Gg          , Mm          , Hh          , Hh          
Mm          , Hh          , Hh          , Hh          , Hh          , Gg          , Gg          , Gs^Fp       , Gs^Fp       , Gg          , Gg          , Ggf         , Ww          , Ww          , Gg          , Gg          , Gg          , Gg          , Gg          , Hh          , Hh          , Hh          
Mm          , Hh          , Hh          , Hh          , Hh          , Hh          , Gg          , Gg          , Gs^Fp       , Gg          , Gg          , Gg          , Wwf         , Gg          , Gg          , Gg^Fet      , Gg          , Ggf         , Hh          , Hh          , Mm          , Mm          
Mm          , Mm          , Hh          , Hh          , Gg          , Gg          , Gg          , Gs^Fp       , Gg          , Gg          , Ww          , Ww          , Gg          , Gg          , Gg          , Gg          , Gg          , Hh          , Hh          , Hh          , Mm          , Mm          
Mm          , Mm          , Hh          , Hh          , Hh          , Gg          , Ggf         , Gg          , Ggf         , Gg          , Ww          , Ss          , Gg          , Gg          , Gg^Fet      , Gg          , Hh          , Hh          , Hh          , Hh          , Mm          , Mm          
Mm          , Mm          , Mm          , Hh          , Hh          , Gg          , Gg          , Gg          , Gg          , Gg          , Ww          , Ss          , Gg          , Gg          , Gg          , Gg          , Gg          , Hh          , Hh          , Mm          , Mm          , Mm          
Mm          , Mm          , Mm          , Hh          , Hh          , Hh          , Gg          , Gg          , Gs^Fp       , Gg          , Gg          , Ww          , Gg          , Ggf         , Ggf         , Gg          , Gg          , Hh          , Hh          , Mm          , Mm          , Mm          
Mm          , Mm          , Mm          , Hh          , Hh          , Gg          , Gs^Fp       , Gg          , Gg^Vh       , Gs^Fp       , Gg          , Ww          , Gg          , Gg          , Gg          , Gg          , Hh          , Hh          , Hh          , Mm          , Mm          , Mm          
Mm          , Mm          , Ch          , Hh          , Hh          , Gg          , Gs^Fp       , Gs^Fp       , Gg          , Gg          , Gg          , Ww          , Gg          , Gs^Fp       , Gs^Fp       , Gg          , Gg          , Hh          , Hh          , Mm^Vhh      , Mm          , Mm          
Mm          , Mm          , Kh          , Ch          , Hh          , Hh          , Hh          , Hh          , Gg          , Gg          , Ss          , Wwf         , Gg          , Gg          , Gs^Fp       , Gs^Fp       , Hh          , Hh          , Hh          , Mm          , Mm          , Mm          
Mm          , Mm          , Mm          , Ch          , Hh          , Gg          , Gg          , Ggf         , Gg          , Ss          , Ww          , Ww          , Gg          , Gg          , Gg          , Gg          , Gs^Fp       , Hh          , Gs^Fp       , Mm          , Mm          , Mm          
Mm          , Mm          , Mm          , Mm          , Hh          , Gg          , Gg          , Gg          , Gg          , Ss          , Ww          , Ss          , Gg          , Gg          , Gg          , Gg          , Gg          , Gs^Fp       , Mm          , Gs^Fp       , Mm          , Mm          
Mm          , Mm          , Mm^Vhh      , Mm          , Hh          , Hh          , Gg          , Gg^Fet      , Gg          , Ss          , Ww          , Ss          , Ss          , Gg          , Gg          , Gg          , Hh          , Hh          , Mm          , Mm          , Mm          , Mm          
Mm          , Mm          , Mm          , Mm          , Hh          , Hh          , Gg          , Ggf         , Gg          , Ss          , Ss          , Ww          , Ss          , Gg          , Gg          , Gs^Fp       , Gs^Fp       , Hh          , Mm          , Mm          , Mm          , Mm          
Mm          , Mm          , Mm          , Mm          , Hh          , Hh          , Gg          , Gg          , Ss          , Ss          , Ww          , Ww          , Ww          , Ss          , Gg          , Gg          , Gs^Fp       , Hh          , Mm          , Mm          , Mm          , Mm          
Mm          , Mm          , Mm          , Hh          , Ww          , Ww          , Wwf         , Ww          , Ww          , Ww          , Ww          , Gg^Vh       , Ww          , Ss          , Ss          , Gg          , Gg          , Hh          , Mm          , Ch          , Ch          , Mm          
Ww          , Ww          , Ww          , Ww          , Hh          , Gg          , Gg          , Ss          , Ww          , Ww          , Ww          , Ww          , Ww          , Ww          , Ss          , Gg          , Gg          , Mm          , Mm          , Kh          , Ch          , Mm          
Mm          , Mm          , Mm          , Hh          , Hh          , Gg          , Gg          , Ss          , Ss          , Ww          , Ww          , Ww          , Ww          , Ss          , Gg          , Gg          , Hh          , Mm          , Mm          , Ch          , Mm          , Mm          
Mm          , Mm^Vhh      , Mm          , Mm          , Hh          , Gg          , Ggf         , Gg          , Gg          , Ss          , Ss          , Ww          , Ss          , Ss          , Gg          , Gg          , Hh          , Mm          , Mm          , Mm          , Mm          , Mm          
Mm          , Mm          , Mm          , Mm          , Hh          , Gg          , Gg          , Gs^Fp       , Gs^Fp       , Gg          , Gg          , Ww          , Gg          , Gg          , Ggf         , Gg          , Hh          , Mm          , Mm          , Mm          , Mm          , Mm          
Mm          , Mm          , Ch          , Mm          , Hh          , Hh          , Gg          , Gs^Fp       , Gg          , Gg          , Ww          , Ww          , Gg          , Gg          , Hh          , Hh          , Mm          , Mm          , Mm          , Mm^Vhh      , Mm          , Mm          
Mm          , Ch          , 1 Kh        , Ch          , Mm          , Hh          , Hh          , Gg          , Gg          , Gg          , Wwf         , Gs^Fp       , Gs^Fp       , Gg          , Gg          , Hh          , Hh          , Mm          , Mm          , Mm          , Hh          , Mm          
Mm          , Ch          , Ch          , Ch          , Mm          , Hh          , Hh          , Gg          , Ww          , Ww          , Gg          , Gg          , Gg          , Gg          , Gg^Fet      , Gg          , Hh          , Mm          , Mm          , Mm          , Hh          , Mm          
Mm          , Mm          , Mm          , Mm          , Mm          , Mm          , Hh          , Ww          , Ww          , Ww          , Ww          , Gg          , Gg          , Ggf         , Gg          , Gg          , Hh          , Hh          , Hh          , Hh          , Mm          , Mm          
Mm          , Mm          , Mm          , Mm          , Mm          , Mm          , Hh          , Ww          , Ww          , Ww          , Hh          , Hh          , Ggf         , Gg          , Gg          , Gg          , Hh          , Hh          , Mm          , Mm          , Mm          , Mm          
Mm          , Mm          , Mm^Vhh      , Mm          , Mm          , Mm          , Hh          , Ww          , Hh          , Ww          , Hh          , Hh^Vhh      , Hh          , Gs^Fp       , Gs^Fp       , Ggf         , Hh          , Mm          , Mm          , Mm          , Mm          , Mm          
Mm          , Mm          , Mm          , Mm          , Mm          , Mm          , Mm          , Hh          , Gg          , Gs^Fp       , Gs^Fp       , Gg          , Hh          , Gs^Fp       , Gg          , Gg          , Hh          , Mm          , Ch          , Mm          , Mm          , Mm          
Mm          , Mm          , Mm          , Mm          , Mm          , Mm          , Mm          , Hh          , Gg          , Gs^Fp       , Gg          , Gg          , Hh          , Gg          , Gg          , Gg          , Hh          , Ch          , Kh          , Ch          , Mm          , Mm          
Mm          , Mm          , Hh          , Mm          , Mm          , Mm          , Hh          , Hh          , Hh          , Gg          , Ggf         , Gg          , Hh          , Gg          , Hh          , Gg          , Mm          , Ch          , Rd          , Hh          , Mm          , Mm          
Mm          , Mm          , Mm          , Mm          , Mm          , Hh          , Mm          , Mm          , Hh          , Hh          , Hh          , Hh          , Hh          , Gg          , Hh          , Hh          , Mm          , Hh          , Rd          , Hh          , Mm          , Mm          
Mm          , Mm          , Mm          , Mm          , Mm          , Mm          , Mm          , Mm          , Hh          , Hh^Vhh      , Hh          , Hh          , Hh          , Hh          , Mm          , Mm          , Mm          , Rd          , Hh          , Hh          , Mm          , Mm          
Mm          , Mm          , Mm          , Mm          , Mm          , Mm          , Mm          , Mm          , Hh          , Hh          , Ds          , Hh          , Hh          , Hh          , Mm          , Hh          , Hh          , Rd          , Hh          , Mm          , Mm          , Mm          
Mm          , Mm          , Mm          , Mm          , Mm          , Mm          , Mm          , Mm          , Hh          , Ds          , Ql          , Ds          , Ds          , Hh          , Mm          , Hh          , Rd          , Rd          , Hh          , Mm          , Mm          , Mm          
Mm          , Hh          , Mm          , Mm          , Mm          , Mm          , Hh          , Hh          , Rd          , Ds          , Ds          , Ql          , Ds          , Hh          , Mm          , Hh          , Rd          , Hh          , Hh          , Mm          , Mm          , Hh          
Mm          , Mm          , Mm          , Mm          , Hh          , Hh          , Rd          , Rd          , Hh          , Hh          , Ds          , Ql          , Ds          , Hh          , Hh          , Hh          , Rd          , Hh          , Hh^Vhh      , Mm          , Hh          , Hh          
Hh          , Hh          , Hh          , Hh          , Rd          , Rd          , Mm          , Mm          , Mm          , Hh          , Hh          , Ds          , Hh          , Rd          , Rd          , Hh          , Rd          , Hh          , Hh          , Hh          , Mm          , Mm          
Rd          , Gs^Fp       , Rd          , Rd          , Hh          , Hh          , Mm          , Mm          , Mm          , Mm          , Mm          , Mm          , Mm          , Hh          , Hh          , Rd          , Hh          , Rd          , Rd          , Hh          , Hh          , Mm          
